11111111111111111111
10000000000000000101
10000001000001010001
10100010010001000001
10000100000000000101
10010000000010100001
10000111110000010001
10000010000000010001
11110000000000000001
10000000000110000001
10000010000000000001
10001000000100000101
10000010000100000001
10000000000100100001
10000011000000000011
10000000011110000001
10110010001000100101
10000000000010100001
10000100000011000001
11111111111111111111
